{
  "h1": "0",
  "h2": "20",
  "h3": "40",
  "h4": "60",
  "h5": "80",
  "h6": "100"
}